0000000000000000000000
0010000000000000000000
0111000000001100000000
0000000000000110000010
0000000000000000001110
0000001000000000000000
0000001000000000000000
0000001100000001000000
0110000000000011000000
0010000000000001000000
0010000000000000000000
0000011000000000000000
0000011000011110000100
0000000000000000001110
0000000000000000000000
0010000010000000000000
0110000010000000000000
0010000010000010000000
0000000010000011000000
0000000000000001000000
0001100000000000000000
0001100000000000000000
#