0000000000000000000000
0101010101010101010100
0000000000000000000000
0010101010101010101010
0000000000000000000000
0101010101010101010100
0000000000000000000000
0010101010101010101010
0000000000000000000000
0101010101010101010100
0000000000000000000000
0010101010101010101010
0000000000000000000000
0101010101010101010100
0000000000000000000000
0010101010101010101010
0000000000000000000000
0101010101010101010100
0000000000000000000000
0010101010101010101010
0000000000000000000000
0000000000000000000000
#